
########
#O   P #
#  X   #
#XO  X #
#   O  #
########