  #####
###  P#
#O X  #
### XO#
#O##X #
# # O ##
#XXOXXO#
#   O  #
########