####
#  #######
#  OOOOOO#
#  ##### #
##   XP# #
 #  XXXX #
 ##  X ###
  #    #
   ####