       ############
       #OOOOOOOOOO#
     ###O#O#O#O#OO#
     #   OOOOOOOOO#
     #P X X X  O O#
    ####### #######
 ####   #    ##  #
##    X #    # X ##
#  #X# ### ###X   ##
# X  X X   # X X X #
#  # X ##       #X #
#   X####X####X##  #
####  ##   #    #  #
   #X ##   # # XX  #
   #   # X #  X    #
   ### # XX #  X ###
     # #    # X ##
     # ######## #
     #          #
     ############
