 #####################
##                   #
#    X #      ## #   #
#  ###### ###  #X## ##
##X#   ##X#OOOO   # #
#  #    X #OOOO## # #
# X # # # #OOOO##   #
# X #X   #OOOO##X# #
# # XPX##X#OOOO##   #
#   X   #OOOO#    #
#  X#   # ###### X###
##  # ###X  X   X #
##     # X  X ##   #
 #####   #   #######
     #########