**XXXXXXXXXXX
X*X*********X
X*XXX*X*XXX*X
X*****X***X*X
XXXXX*XXXXX*X
X***********X
XXXX*XXXXXXXX
X*********X*X
XXX*X*XXX*X*X
X***X***X***X
XXXXX*XXXXX*X
X*********X*X
XXXXXXXXXXX**