******************
*X*X*XXXX*X*XXXXX*
*X*XXX*XX*X*XX*XX*
*X***X****X*XX****
*XXX*XXXXXX*XXXXXX
***X*****XX*X*X***
*XXXXXXX*XX*X*X*X*
*X*******XX*X***X*
*XXXXXXXXXX*XXXXX*
*********X********