00S0000000E00
0010000000100
0010000000100
0010000000100
0010111100100
0010100100100
0011100100100
0000000100100
0000000111100
0000000000000
