111111111111111111111111111111111111111111111111111111111111111111111111111111111111111111111111111111111222222222222222222222222222222222222222222222222222222222222222222222222222222222222222222222222222222222
111111111111111111111111111111111111111111111111111111111111111111111111111111111111111111111111111111111222222222222222222222222222222222222222222222222222222222222222222222222222222222222222222222222222222222
000000000000001000010000000000000000010000001000000110000000001011010010000000000000000000000010001111111222222111111111111111111111122222222222222222222222222222222222222222222222222222222222222222222222222222
000000100000001000010000000000010000010011001100010110100000001011010010101100000100011010000010001111111222222100000000000000000000122222222222222222222211112222222200002222222222221222222222222222222222222222
000000100011000001100000000000010000000011000100010000100000000000000000101100000100011010000000011111111222222100000000000000000000122222222222222002220000012222221110000000022221110122222222222222222222222222
000000000011000001100000000000000000000000000000000000000000000000000000000000000000000000001100011111111222222100000000000000011000122222222222222200000000011111110000100000000221000122222222222222222222222222
010000000000000000000000110000000000000000000000000000000000000000000000000000000000000000001100001111111222222100000000000000011000122222222222222200001100000000000000000000000221000122222222222222222222222222
010000000000000000000000110000000000000000000110000000000000000000000000000000000000000000000010001111111222222100000000004900000000012222222222222220000100000000000000000000010000000011122222222222222222222222
000000000000000000000000000001101110100000000110001000100010010000100000100001011001000011000010101111111222222100011110000000000000122222222222222200000000000000000020002200000100000001112222222222222222222222
000010001000000000001000100001101110100000001000001000100010010000101100100000011001000011001000101111111222222100001110000000000000122222222222222200000000011111100020222200000000000000011222222222222222222222
000010001000100010001000100000000000000000001000000000000000000000001100000000000000000000001000011111111222222100000000000000000000122222222222222000000000012222222222222220000000011000001222222222222222222222
000000000000100010000000000010000111111111111111111111111111111111111111111111111111100011111110011111111222222100000000000000000000122222222222222200000000012222222222222222222200001110001122222222222222222222
000000000001100000000000000010001111111111111111111111111111111111111111111111111111100011111111001111111222222100000000000000000000122222222222222200000000012222222222222222222220000000000122222222222222222222
000000001001100000001000000010011111111111111111111111111111111111111112222100000000000000000011101111111222222100000000000011111000122222222222222211000000012222222222222222222222000110000122222222222222222222
000000001000000000001000000010111220000000001000000000000000000000000122222100000000000000000001111111111222222100001110000011110000122222222222222221000000012222222222222212222222000001000122222222222222222222
000000000001000011001000000001112220000000001000000000000000000000000122222100000000000000000000111111111222222100001110000000000000122222222222222221111100112222222222222211122222000000100112222222222222222222
000001000001000011000000100001122220000000001000000000000000000000000122222100000000000000000000011111111222222100001100000000000000122222222222222222000000002222222222220000002222200000000012222222222222222222
000001000000000000000000100001122220000000000000000000000000000000000122222100000000000000000000011111111222222100000000000000000000122222222222222222200000022222222222222000000022222200000012222222222222222222
000100000000000000100110010001122221111110000000011111111000000000000122222100000000000000000000011111111222222100000000000000000000122222222222222222220000022222222222222000000002222200010012222222222222222222
000101100000000000100110010001122220000110000000010000000000000000000122222111111111110001111111111111111222222111111111000000111111122222222222222222222200022222222222222222220000222200000012222222222222222222
000001100010000000000000000001122220000011000000010000000000000000000122222100000010000000010000011111111222222222222220000000222222222222222222222222222222222222222222222222220000222200010012222222222222222222
000000000010000010000000000001122220000001000000010000000000000000000122222100000010000000010000011111111222222222222220000011222222222222222222222222222222222222222222222222222000222200110012222222222222222222
000000001000000010000001000101122220000001000000010000000000000000000122222100000011110001110000011111111222222222222220000011222222222222222222222222222222222222222222222222222000222200110012222222222222222222
000001001000000000010001000101122220000001000000010000000000000000000122222100000000010001000000011111111222222222222222000002222222222222222222222222222200222222222222222222222200222200000012222222222222222222
000001000000100000010000100001122220000000000000000000000001000000000122222100000000010001000000011111111222222222222222200022222222222222222222222222222200222222222222222222222200222200001012222222222222222222
000000000000100011000000100001122220000000000000000000000001000000000222222100000000010001000000011111111222222222222222222222222222222222222222222222222220222222222222222222210000222200000012222222222222222222
001000000000000011000000000001122220000000000000000000000001000000002222222100000000010001000000011111111222222222222222222222222222222222222222222222222222222222222222222222110000222220010012222222222222222222
001000000000000000000000000001122220000000000000000000010001000000022222222100000000110001000000011111111222222222222222222222222222222222222222222222222222222222222222222222100000222220000012222222222222222222
000101100000000000000110000001122220000000000000000000010001000000222222222100000000110001000000011111111222222222222222200022200002220002200000222222222222222222222222222222100022222220000012222222222222222222
000101100000000000100110010001122222000000000000000001111111000000222222222100000000110001000000011111111222222222222222200022200002220002200000222222222200222222222222222222100222222220000012222222222222222222
000001100010000000100110010101122222200000000000000011000000000002222222222100000000110001000000011111111222222222222222222222220222222222222222222200002200000112222222222222122222222220000012222222222222222222
000001100010010000000110000101122222220000000000000000000000000022222222222100000111110001111100011111111222222222222222222222222222222222222220002200002200000002222222222222122220000222000012222222222222222222
000000000000010000000000000001122222222200000000000000000000000222222222222100000000000000000000011111111222222222222222222222222222222222222220002200002200000002222222222222222220000222200022222222222222222222
010111100001100011000011110001122222222222200000000000000000002222222222222100000000000000000000011111111222222222222222222222222222222222222220002200002200000002222222222222222222001022222222222222222222222222
010111100001100011000011110001122222222222222222222222222222222222222222222100011111110001111100011111111222222222222222222222222222222222222222222222222222022222222222222222222222222222222222222222222222222222
000111100001100011000011110001122222222222222222222222222222222222222222222100000000010001000000011111111222222222222222222222222222222222222222222222222222222222222222222222220002222222222222222222222222222222
000111100001100011000011110001122222222222222222222222222222222222222222222100000000010001000000011111111222222222222222222222222222222222222222222222222222222222222222222222200000022222222222222222222222222222
000000000000100000100000000101122222222200000000000000000000022222222222222100000000010001000000011111111222222222222222222222222222222222222222222222222222222222222222222222200000022222222222222222222222222222
000000000000100000100000000101122222222200000000000000000000022222222222222100000000010001000000011111111222222222222222222222222222222222222222222222222222222222222222222222220002222222222222222222222222222222
000000000000000000000000000001122222222220000000000000000000222202222222222100000000010001000000011111111222222222222222222222222222222222222222222222222222222222222222222222222222222222222222222222222222222222
010001000000000000000000001001122222222220000000000000000000222002222222222100000000010001000000011111111222222222222222222222222222222222222222222222222222222222222222222222222222000222222222222222222222222222
010001000100000000000000001001122222202222000000000000000002222002022222222100000000010001000000011111111222222222222222222222222222222222222222222222222222222222222222222222222222000222222222222222222222222222
000111100101100001100011110001122222200222200000000000000022002202002222222100011111111111111100011111111222222222222222222222222222222222222222222222222222222222222222222222222222200222222222222222222222222222
000111100001100001100011110001122222200022200000000000000222002222002222222100000100000000000000011111111222222222222222222222222222222222222222222222222222222222222222222222000222200222222222222222222222222222
000111100001100011100011110001122222200222220000000000002222002220002222222100000100000000000000011111111222222222222222222222222222222222222222222222222222222222222222222222000022222222222222222222222222222222
000111100001101011100111110101122222222222220000000000022222222200002222222100000100000000000000011111111222222222222222222222222222222222222222222222222222222222222222222222000022222222222222222222222222222222
001000000000001000000100000101122222222222222000000002222222222222222222222100011111000000000000011111111222222222222222222222222222222222222222222222222222222222222222222222000022222222222222222222222222222222
001000000000000000000000000001122222222222222220022222222022000220022222222100010001110000000000011111111222222222222222222222222222222222222222222222222222222222222222222222200022000222222222222222222222222222
000000000000000000000000000101122222222222222222222222220002000220022222222100011000011111000000011111111222222222222222222222222222222222222222222222222222222222222222222222222222000220222222222222222222222222
000000000100000000000000000101122222200222222222222000020022002200022222222100001000010001111100011111111222222222222222222222222222222222222222222222222222222222222222222222222222000000222222222222222222222222
000111100101100001100011110001122222200022222222222200022222222222222222222100001000010000000100011111111222222222222222222222222222222222222222222222222222222222222222222222222222000000222222222222222222222222
010111100001100001100011110001122222220222222222222200022222222222202222222100001110011111111100011111111222222222222222222222222222222222222222222222222222222222222222222222222222000000222222222222222222222222
010111100001100001100011110001122222222222222222200220022222222222000222222100000010001000000000011111111222222222222222222222222222222222222222222222222222222222222222222222222222020002222222222222222222222222
000111100001100001100011110001122222222222000022200222222222222222000222222100000010001000000000011111111222222222222222222222222222222222222222222222222222222222222222222222222002220222222222222222222222222222
000000000000000100000000001001122222220022000022220222222222222002200022222100000010001000000000011111111222222222222222222222222222222222222222222222222222222222222222222222220002222222222222222222222222222222
000000000000000100000000001001122222120022200022200222222222220000222222222100011110001000000000011111111222222222222222222222222222222222222222222222222222222222222222222222220002222222222222222222222222222222
000000000000000000000000000001122222122222222222200222222222220002222202222100011110001111111110011111111222222222222222222222222222222222222222222222222222222222222222222222222222222222222222222222222222222222
000001000000000000000011110001122222120022222002222222200022220222222202222100000010001000000000011111111222222222222222222222222222222222222222222222222222222222222222222222222222222222222222222222222222222222
001001000000100000000011110001122222120002220000222222200022222202222222222100000010000000000000011111111222222222222222222222222222222222222222222222222222222222222221111122222222222222222222222222222222222222
001000000011100001100011110001122222122002220000222222222222222000222222222100110010000000000000011111111222222222222222222222222222222222222222222222222222222222211110000111110022222222222222222222222222222222
000111100011000001100011110001122222122202222222222222222222222000222222222100110010011111111110011111111222222222222222222222222222222222222222222222222222222222000000000000000022222222222222222222222222222222
000111100011000001100000000001122222122222222022222222222222222200222222222100110010001000000000011111111222222222222222222222222222222222222222222222222222222200000000000000000012222222222222222222222222222222
000111100011000001100000000001122222120002220002222220002222222222222022222100110010001000000000011111111222222222222222222222222222222222222222222222222222222000000110011111100012222222222222222222222222222222
000111100000000000000011110001122222122002220002222220002222220222220002222100110010001000000000011111111222222222222222222222222222222222222222222222200022222000000100000001000012222222222222222222222222222222
010000000000000000000011110101122222102222220002222222222222220002220002222100110010001000000000011111111222222222222222222222222222222222222222222222000000220000000100000001100011222222222222222222222222222222
010000000000000000000011110101122222100022222222222222222222200002200022222100110010001111111100011111111222222222222222222222222222222222222222222222200000222210000000000000100001222222222222222222222222222222
000000000011000001100011110001122222100022222222222222222222222222220022222100110010011111111100011111111222222222222222222222222222222222222222222222222202222211000000000000100001122222222222222222222222222222
000111100011000001100000000001122222100022200222222222222222222222222222222100110010000000000100011111111222222222222222222222222222222222222222222222222222222221100000000000100000122222222222222222222222222222
000111100011000001100000000001122222100022200222222222222222222222222222222100110010000000000100011111111222222222222222222222222222222222222222222220002222222222111000000000000000122222222222222222222222222222
000111100011000001100000000111122222100222222222222222222222222222222200022100000010001111111100011111111222222222222222222222222222222222222222222220000002222222221110000000000000122222222222222222222222222222
000111100000000000000000001111122222100222222222222222222222222222222000022100000000001000000000011111111222222222222222222222222222222222222222222200000002222222222211100000000011122222222222222222222222222222
000000000000000000000000001111122222100222000222200022200022222222222222222100000000001000000000011111111222222222222222222222222222222222222222222222222222222222222222100111111112222222222222222222222222222222
000000000000000000000000011111122222102222000022200022000022202002200222222100000000001111111100011111111222222222222222222222222222222222222222222222222222222222222222100222222222222222222222222222222222222222
000000000000000011000001111111122222102222000022000022200222002002200022222100000000001000000000011111111222222222222222222222222222222222222222222222222000222222222222200022222222222222222222222222222222222222
000000100000000011000011111111122222102222202222022222222220002000200002222100000000001000000000011111111222222222222222222222222222222222222222222222220000222222222222222222222222222222222222222222222222222222
001100100001000000100111111111122222102222222222222222222220002000200000222000000000000000000000011111111222222222222222222222222222222222222222222222222000222222222222222222222222222222222222222222222222222222
001100000001000000100111111111112222102222222222222222222222222222222222222000000000000000000000111111111222222222222222222222222222222222222222222222222200222222222222222222222222222222222222222222222222222222
000000000000000000000111111111111222222222222222222222222222222222222222222000000000000000000001111111111222222222222222222222222222222222222222222222222222222222222222222222222222222222222222222222222222222222
000100000000000001110011111111111122222222222222222222222222222222222222222000000000000000000011111111111222222222222222222222222222222222222222222222222220022222222222222222222222222222222222222222222222222222
000100001000000001110001111111111111111111111111111111111111111111111111111111111111111111111111111111111222222222222222222222222222222222222222222222222220000000022222222222222222222222222222222222222222222222
000000001010100000000001111111111111111111111111111111111111111111111111111111111111111111111111111111111222222222222222222222222222222222222222222222222200000100022222222222222222222222222222222222222222222222
000000000010100000000000011111111111111111111111111111111111111111111111111111111111111111111111111111111222222221111111111111111111111111111111111222222200000100000222222222222222222222222222222222222222222222
000001000000000000010000010000000000000001000000000000000000000000000000000000100000000000000000001111111222222220000000000000000000000000001000000222222200000100000122222222222222222222222222222222222222222222
000001000011000000010000010010000000000001000001000000000000000000000000000000000000000000000000001111111222222220000000000000000000000000001000000222222200000100000122222222222222222222222222222222222222222222
000100001011000000000000000010000000100000000001001010001000010000000010000000000000001000000000101111111222222220000000000010000000000000011000000222222200000100000122222222222222222222222222222222222222222222
000100101000100011000000001000100111100000011000001011101000010110000010011010001000101110000000101111111122222222200000000010000000000000010000000222222200000000000122222222222222222222222222222222222222222222
000000100000100011000000001000100111000000011000000001100000000110000000011010001000100110000000001111111122222222220001000010000000000000010000000222222200011111111122222222222222222222222222222222222222222222
000000000000000000000000000000000000000000000000000000000000000000000000000000110000000000000001101111111111112222220001120010000000000000010000022222000221122222222222222222222222222222222222222222222222222222
000000001001100000000000000000000000000000000000011000000000000000000000000000110000000000000001101111111111112222222002220010001111111100000002222222000022222222222222222222222222222222222222222222222222222222
000000001001100000000000000000000000000000000000011000000000000000000000000000000000000000000000001111111111112222222222000000000000100000000022220222010022222222222222222222222222222222222222222222222222222222
000010000000001001100001100000000110000011000000100000000011010000000000011000000000000110000000101111111111110000000000010000000000100000000222200022011022222222222222222222222222222222222222222222222222222222
000010000000001001100001101000000110100111000000100000000011010000000010011000000000100110000000101111111111000000000000000000000000100000000220000022000022222222222222222222222222222222222222222222222222222222
000000000000000000000100001000100000100100000000000000000000000000000010000000000000100000000000001111111000000002200000000000000000100000000222000022222222222222222222222222222222222222222222222222222222222222
000110000100000000000100000000100000000000010010000000000001000000000000000000000000000000100000001111110000000002220002220000000000100000000022200222222222222222222222222222222222222222222222222222222222222222
000110010100000000000000100000001000000000010010000000000001000001100000000101000000000000111000001111000000000022222222220001111111100011000022222222222222222222222222222222222222222222222222222222222222222222
001000010000000100010000100000001000000001000000010000010000000001101000000101000000010000011000001110000000010022200002220000000000000011000000000022222222222222222222222222222222222222222222222222222222222222
001000000000000100010000000000000000010001000000010000010000000100001000000000000000010000000000000000000000110022220000220000000000000001110000000022222222222222222222222222222222222222222222222222222222222222
000000000000000000000000000000000000010000000000000000000000000100000000000000000000000000000000000000000111111112200000020000111110000000000000000022222222222222222222222222222222222222222222222222222222222222
111111111111111111111111111111111111111111111111111111111111111111111111111111111111111111111111111111111111111112220000020000011100000000000000000022222222222222222222222222222222222222222222222222222222222222
111111111111111111111111111111111111111111111111111111111111111111111111111111111111111111111111111111111111111112222111111111111111111111111111111122222222222222222222222222222222222222222222222222222222222222