########################
#  P                   #
#                 X    #
#                X     #
#                 X    #
#         OOO          #
########################
